진흥왕은 몇대 왕인가요?	24대
진흥왕이 즉위한 년도는 언제인가요?	540년
진흥왕은 몇년간 재위했었나요?	37년
24대 신라왕은 누구인가요?	진흥왕
진흥왕의 이름은 무엇인가요?	삼맥종 또는 심맥부
진흥왕의 성은 무엇인가요?	김씨
진흥왕은 누구의 손자인가요?	지증왕
진흥왕의 할아버지는 누구인가요?	지증왕
입종갈문왕의 아들은 누구인가요?	진흥왕
진흥왕의 아버지는 누구인가요?	입종갈문왕
진흥왕의 아빠는 누구인가요?	입종갈문왕
법흥왕의 아우는 누구인가요?	입종갈문왕
입종갈문왕의 형은 누구인가요?	법흥왕
진흥왕의 어머니는 누구인가요?	법흥왕의 딸 김씨
진흥왕의 부인은 누구인가요?	사도부인
진흥왕이 즉위한 나이는 몇살인가요?	7세
진흥왕 대신 누가 섭정하였나요?	왕태후 김씨
신라의 대외적 발전을 비약적으로 추진시킨 왕은 누구인가요?	진흥왕
즉위 초에 섭정을 한 사람은 누구인가요?	왕태후 김씨
개국이라고 연호를 바꾼 연도는 언제인가요?	551년
진흥왕은 연호를 무엇으로 바꾸었나요?	개국
친정을 시작하면서부터 무엇을 하였나요?	대외정복사업
백제는 어디와 도살성과 금현성에서 공방전을 펼쳤나요?	고구려
고구려는 어디와 도살성과 금현성에서 공방전을 펼쳤나요?	백제
백제와 고구려가 도살성과 금현성에서 공방전을 벌인 연도는 언제인가요?	550년
병부령으로 임명된 사람은 누구인가?	이사부
이사부는 어떤 성을 빼앗았나요?	도살성과 금현성
고구려가 점유하고 있던 한강유역을 누구와 연합하여 공격하였나요?	백제의 성왕
언제 한강 하류 유역의 전략적인 필요성을 절감하고 점령하였나요?	553년
한강유역 통치를 위해 설치한 것은 무엇인가요?	신주
신주의 초대 군주는 누구인가요?	아찬 김무력
백제 성왕이 대가야와 연합해 신라를 공격한 연도는 언제인가요?	554년
백제 성왕이 대가야와 연합해 신라와 싸운 전투는 무엇인가요?	관산성전투
관산성전투에서 활약한 신주 군주는 누구인가요?	김무력
신라가 백제로부터 한강 하류 유역을 탈취한 사건은 어떤 것을 파기했나요?	결혼동맹
신라는 결혼 동맹을 어디와 했나요?	백제
신라가 백제와 한 동맹의 이름은?	결혼동맹
인적 물적 자원의 획득과 중국과의 교통로 역할을 하는 곳은 어디인가요?	한강유역
중국 남조의 진과 북조의 북제 두 나라에 사신을 파견한 연도는 언제인가요?	564년
어떤 사람의 가야에 대한 정복 사업을 계승하였나요?	법흥왕
법흥왕은 어디 정복 사업을 하였나요?	가야
법흥왕의 정복사업을 계승하여 어디까지 정복의 손을 뻗쳤나요?	낙동강유역
비사벌에 완산주가 설치된 연도는 언제인가요?	555년
555년에 비사벌에 무엇이 설치되었나요?	완산주
관산성전투에서 승리한 나라는 어디인가요?	신라
백제와 연합했던 나라는 어디인가요?	대가야
어떤 전투에서 신라가 승리 후 대가야가 사실상 신라에 복속되었나요?	관산성전투
대가야가 신라에 대해 반란을 일으킨 연도는 언제인가요?	562년
대가야를 무력으로 정복하여 말망시킨 사람은 누구인가요?	이사부
대야주를 언제 설치하였나요?	565년
565년에 설치된 것은 무엇인가요?	대야주
가야지역 통치의 본거지로 삼는 동시에 백제에 대한 방어의 전초기지로 삼은 것은 무엇인가요?	대야주
비열홀주를 설치한 연도는 언제인가요?	556년
556년에 설치된 것은 무엇인가요?	비열홀주
비야홀주의 군주로 누구를 임명하였나요?	사찬 성종
사천 성종은 어디의 군주로 임명되었나요?	비열홀주
함흥평야까지 진출한 듯한 연도는?	568년
568년 이전 어느시기에 어디까지 진출하였나요?	함흥평야
신라의 한강유역 점령은 어떤 의미가 있나요?	인적 물적 자원의 획득 외에도 황해를 통한 중국과의 교통로를 확보함
진흥왕이 백제의 한강 하류 유역을 점령한 연도는 언제인가요?	553년
진흥왕은 553년에 백제의 어느 지역을 점령하였나요?	한강 하류 유역
한강유역을 통치하기 위해 무엇을 설치하였나요?	신주
신주의 초대 군주는 누구인가요?	아찬 김무력
신주는 어느 지역을 통치하기 위해 설치되었나요?	한강유역
신라가 백제로부터 한강 하류 유역을 탈취한 사건은 무엇을 의미하나요?	결혼 동맹 파기
백제 성왕은 어디와 연합하여 신라를 공격하엿나요?	대가야
백제 성왕이 죽음을 당한 전투는 무엇인가요?	관산성전투
백제 성왕은 관산성전투에서 누구에게 붙잡혔나요?	김무력
백제 성왕이 대가야와 연합하여 신라를 공격한 연도는 언제인가요?	554년
관산성전투에서 승리한 나라는 어디인가요?	신라
관산성전투에서 패배한 나라는 어디인가요?	백제
554년 대가야와 연합해 신라를 공격한 왕은 누구인가요?	백제 성왕
백제가 고구려로부터 탈환하였던 지역은 어디인가요?	한강 하류 유역
신라가 한강유역을 차지하기 위해 공격한 나라는 어디인가요?	백제
백제성왕이 김무력에게 잡힌 전투는 무엇인가요?	관산성전투
신라는 어느 지역을 탈취하여 백제와 맺은 결혼 동맹을 파기하게 되었나요?	한강 하류 유역
신라가 한강유역을 차지한 연도는 언제인가요?	553년
즉위 초 진흥왕을 섭정한 사람은?	왕태후
진흥왕이 연호를 개국으로 바꾼 년도는?	551년
진흥왕이 551년에 바꾼 연호는?	개국
진흥왕이 551년에 전개한 사업은?	대외정복사업
신라의 24대왕은?	진흥왕
진흥왕의 이름은?	삼맥종
지증왕의 손자는?	진흥왕
진흥왕의 할아버지는?	지증왕
진흥왕의 조부는?	지증왕
진흥왕의 아버지는?	입종갈문왕
진흥왕의 어머니는?	법흥왕의 딸 김씨
신라의 대외적 발전을 비약적으로 추진시킨 왕은?	진흥왕
왕태후 김씨의 아들은?	진흥왕
입종갈문왕의 아들은?	진흥왕
진흥왕은 신라 몇대 왕인가?	24대
입종 갈문왕의 형은?	법흥왕
진흥왕은 몇 살에 즉위했나요?	7살
진흥왕이 즉위한 해는?	540년
진흥왕의 왕비는?	박씨
사도부인의 남편은?	진흥왕
왕태후 김씨가 섭정을 시작한 연도는?	540년
신라가 564년부터 거의 매년 사신을 파견한 나라는?	북조의 북제
신라가 중국의 남조의 진과 북조의 북제와 외교관계를 시작한 해는?	564년
진흥왕이 법흥왕의 가야에 대한 정복사업을 계승하여 손을 뻗친 지역은?	낙동강 유역
비사벌에 완산주가 설치된 연도는?	555년
555년에 비사벌에 설치된 것은?	완산주
완산주가 설치되기 전에 신라에 점령된 가야는?	아라가야
진흥왕 이전에 가야 정복사업을 진행한 왕은?	법흥왕
신라가 중국과의 교통로를 확보하게된 계기는?	한강유역 점령
신라가 백제에게 승리한 전투는?	관산성전투
관산성 전투 이후 신라에 복속된 국가는?	대가야
관산성 전투 당시 백제와 연합했던 국가는?	대가야
관산성 전투 당시 대가야와 연합했던 국가는?	백제
대가야가 신라에 반란을 일으킨 연도는?	562년
대가야가 일으킨 반란을 막고 정복한 장수는?	이사부
백제에 대한 방어의 전초기지로 삼은 곳은?	대야주
신라가 대야주를 설치한 이유는?	백제에 대한 방어의 전초기지
556년에 설치한 곳은?	비열홀주
비열홀주의 군주는?	사찬 성종
성종의 직위는	사찬
사찬 성종이 군주로 있던 곳은?	비열홀주
신라가 함흥평야까지 진출한 시기는?	568년
신라가 568년 진출한 곳은?	함흥평야
진흥왕의 할아버지는?	지중왕
진흥왕이 즉위한 나이는?	7세
진흥왕이 백제의 성왕과 연합해 고구려를 공격한 곳은?	한강유역
진흥왕이 553년에 한일은?	백제공격
한강유역 초대 군주의 이름은?	김무력
반란을 일으킨 대가야를 멸망시킨 장군의 이름은?	이사부
백제 성왕이 대가야와 연합해 신라를 공격한 연도는?	554년
백제 성왕이 붙잡혀 죽음을 당한 전투는?	관산성전투
진흥왕 어머니의 아버지는?	법흥왕
진흥왕이 개국이라고 연호를 바꾼 연도는?	551년
진흥왕이 재위 기간은?	540~576년
한강유역 점령의 외교적 의미는?	중국과의 교통로 확보
비사벌에 완산주가 설치된 연도는?	555년
비열홀주를 근거로 568년 이전에 어디까지 진출했는가?	함흥평야
556년에 설치된 비열홀주의 군주는?	사찬 성종
대야주를 설치하여 가야지역 통치의 본거지로 삼은 연도는?	565년
비사벌에 완산주가 설치된 연도는?	555년
564년 이래 거의 매년 사신을 파견한 중국 남조의 나라는?	진
564년 이래 거의 매년 사신을 파견한 중국 북조의 나라는?	북제
왕태후의 섭정을 벗어나 친정을 시작한 연도는?	551년
신라 24대왕은 누구인가?	진흥왕
진흥왕의 성은 무엇인가?	김
진흥왕의 이름은 무엇인가?	삼맥종
지증왕의 손자는 누구인가?	진흥왕
법흥왕의 아우 입종갈문왕의 아들은 누구인가?	진흥왕
법흥왕의 아우는 누구인가?	입종갈문왕
입종갈문왕의 형은 누구인가?	법흥왕
진흥왕의 어머니는 누구인가?	법흥왕의 딸 김씨
법흥왕의 딸 김씨의 아들은 누구인가?	진흥왕
진흥왕의 부인은 누구인가?	사도부인
진흥왕의 왕비는 누구인가?	사도부인
진흥왕 대신 섭정한 사람은?	왕태후 김씨
신라의 대외적 발전을 비약적으로 추진한 왕은?	진흥왕
진흥왕은 연호를 무엇으로 바꾸었나?	개국
진흥왕은 친정을 시작하고 난 후 무엇을 하였나?	대외정복사업
진흥왕이 개국이라고 연호를 바꾼 시기는?	551년
백제와 고구려가 도살성과 금현성에서 공방전을 벌인 시기는?	550년
이사부가 도살성과 금현성을 공격하여 빼앗은 년도?	550년
550년에 도살성과 금현성에서 고구려와 공방전을 벌인 국가는?	백제
550년에 도살성과 금현성에서 백제와 공방전을 벌인 국가는?	고구려
550년에 백제와 고구려가 공방전을 벌인 장소는?	도살성과 금현성
도살성과 금현성을 뺏은 신라 장군은?	이사부
병부령으로 임명된 사람은?	이사부
이사부는 무엇으로 임명되었나?	병부령
고구려가 점유하고 있던 한강유역을 누구와 연합해 공격하였나?	백제의 성왕
진흥왕은 거칠부를 비롯하여 어떤 장군에게 명하여 한강 상류 유역인 죽령 이북 고현 이남의 10개군을 고구려로부터 빼앗았나?	구진, 비태, 탐지, 비서, 노부, 서력부, 비차부, 미진부 등
진흥왕이 고구려로 부터 빼앗은 한강 상류 유역은?	죽령 이북 고현 이남
진흥왕이 한강 하류 유역을 점령한 시기는?	553년
한강 하류 유역의 통치를 위해 설치한 것은?	신주
신주에 누구를 초대 군주로 임명하였나?	아찬 김무력
신라가 백제로부터 한강 하류 유역을 탈취한 사건은 어떤 것을 의미하나?	결혼 동맹 파기
백제 성왕이 죽음을 당한 시기는?	554년
백제 성왕은 어디와 연합하여 신라를 공격하였나?	대가야
백제 성왕이 죽은 전투는?	관산성전투
백제 성왕은 누구에게 붙잡혔나?	신주 군주 김무력
신라에게 인적 물적 자원의 획득 외에 황해를 통한 중국과의 교통로를 확보해 준 것은?	한강유역 점령
중국 남조의 진과 북조의 북제 두나라에 사신을 파견해 외교관계를 공고히 한 시기는?	564년
누구의 가야에 대한 정복사업을 계승했나?	법흥왕
법흥와의 어디에 대한 정복사업을 계승했나?	가야
법흥왕의 가야에 대한 무엇을 계승했나?	정복사업
법흥왕의 가야에 대한 정복사업을 계승해 어디까지 정복하였나?	낙동강유역
비사벌에 완산주가 설치된 시기는?	555년
555년 비사벌에 무엇이 설치 되었나?	완산주
555년 완산주가 설치된 위치는?	비사벌
대가야가 신라에 대한 반란을 일으킨 시기는?	562년
대가야를 멸망시킨 사람은?	이사부
562년 이사부는 어디를 멸망시켰나?	대가야
565년에 가야 지역 통치의 본거지로 삼는 동시에 백제에 대한 방어의 전초기로 삼은 것은?	대야주
대야주는 어느 시기에 설치 되었나?	565년
556년 동북방면으로 북상해 설치한 것은?	비열홀주
비열홀주는 어느시기에 설치 되었나?	556년
비열홀주의 군주로 누구를 임명하였나?	사찬 성종
사찬 성종은 556년에 어디의 군주로 임명되었나?	비열홀주
함흥평야까지 진출한 시기는?	568년
568년 어디까지 진출 하였나?	함흥평야
진흥왕이 친정을 시작한 시기는?	551년
진흥왕이 대외정복사업을 시작한 시기는?	551년
이사부가 도살성과 금현성을 공격하여 뺏은 시기는?	550년
신라가 동맹관계인 백제를 기습한 시기는?	553년
신라가 한강유역의 전부를 차지하게 된 시기는?	553년
신라가 백제와 맺은 결혼동맹을 파기하게 된 이유는?	한강 하류 유역을 탈취한 사건
백제 성왕이 신주 군주 김무력에게 죽음을 당한 시기는?	554년
대가야가 신라에 정복 멸망된 시기는?	562년
신라가 가야의 여러 나라를 완전히 정복한 시기는?	562년
신라가 낙동강유역 전부를 차지한 시기는?	562년
신라가 가야 지역 통치의 본거지로 삼는 동시에 백제에 대한 방어의 전초기지로 삼기 위해 대야주를 설치한 시기는?	565년
사찬 성종을 군주로 임명한 시기는?	556년
진흥왕은 진흥왕 몇 년에 친정을 시작하였나요?	551년
진흥왕은 신라 몇 대 왕인가요?	24대
진흥왕은 신라의 몇 번째 왕인가요?	24
이사부가 도살성과 금현성을 빼앗은 것은 언제인가요?	550년
신라가 백제 성왕과 연합해 고구려의 한강유역을 공격한 것이 언제인가요?	550년
진흥왕이 연호를 개국이라고 바꾸고 친정을 시작한 것은 언제인가요?	551년
진흥왕이 친정을 시작한 년도는?	551년
진흥왕이 백제가 고구려로부터 탈환한 한강 하류 유역을 기습 공격해 점령한 것은 언제인가요?	550년
신라가 한강 유역 전부를 차지한 것은 언제인가요?	553년
이사부가 신라에 대해 반란을 일으킨 대가야를 무역으로 멸망시킨 해는?	554년
진흥왕은 몇 살에 즉위하였습니까?	7살
왕태후의 섭정에서 벗어나 친정을 시작하면서 진흥왕이 바꾼 연호는 무엇인가요?	개국
신라 진흥왕이 백제와 동맹을 맺고 공격한 나라는?	가야
백제 성왕이 죽음을 당한 전투는?	관산성전투
신라가 한강유역 통치를 위해 설치한 신주의 초대 군주로 임명한 사람은?	김무력
신주의 초대 군주는 누구인가요?	김무력
관상성전투에서 백제 성왕을 붙잡아 죽인 사람은?	김무력